111111111111111111111111111111
1____________________________1
1____________________________1
1____________________________1
1____________________________1
1____________________________1
1____________________________1
122222222222_________________1
1____________________________1
1___________________2222222221
1____________________________1
1____________________________1
1____________________________1
1___________22222222_________1
1____________________________1
1____________________________1
1____________________________1
122222222222_________222222221
1____________________________1
1____________________________1
1____________________________1
111111111111111111111111111111
