111111111111111111111111111111
1____________________________1
1____________________________1
1____________________________1
1____________________________1
1____________________________1
1_____P______________________1
122222222222_________________1
1__________________3____E____4
1___________________2222222221
1____________________________1
1____________________________1
1____________________________1
1____________2222222_________1
1____________________________1
1____________________________1
1___________________3_____E__4
1____________________222222221
1____________________________1
1____________________________1
1____________________________1
111111111111111111111111111111
