111111111111111111111111111111
1____________________________1
1____________________________1
1____________________________1
1____________________________1
1____________________________1
1_____P______________________1
122222222222_________________1
1__________________3____E____4
1___________________2222222221
1____________________________1
1____________________________1
1____________________________1
1________2222222222__________1
1____________________________1
1____________________________1
1___________________3_____E__4
12222222_____________222222221
1____________________________1
1____________________________1
1____________________________1
111111111111111111111111111111
