111111111111111111111111111111
______________________________
______________________________
______________________________
______________________________
______________________________
______________________________
______________________________
______________________________
______________________________
______________________________
______________________________
222222222222_________222222222
______________________________
______________________________
______________________________
______________________________
______________________________
______________________________
______________________________
111111111111111111111111111111
